S - Sideways Wiimote
W - Vertical Wiimote
C - Classic Controller
N - Wiimote+Nunchaku


C WM7P|ANIMA - Ark of Sinners (Europe) (WiiWare)
S WACP|Arcade Essentials (Europe) (WiiWare)
C WBKP|Arkanoid Plus! (Europe) (WiiWare)
S WABP|Art of Balance (Europe) (WiiWare)
W WPRP|Art Style - CUBELLO (Europe) (WiiWare)
S WALP|Art Style - light trax (Europe) (WiiWare)
C WA8P|Art Style - PENTA TENTACLES (Europe) (WiiWare)
W WOBE|Art Style Orbient (World) (WiiWare)
S WDHE|Art Style Rotohex (World) (WiiWare)
S W8CP|Bit. Trip Core (Europe) (WiiWare)
C WBFE|Bit. Trip Fate (USA) (WiiWare)
S WTFP|Bit. Trip Flux (Europe) (WiiWare)
S WRUP|Bit. Trip Runner (Europe) (WiiWare)
S WTRE|Bit.Trip Beat (World) (WiiWare)
C WVBE|Bit.Trip Void (World) (WiiWare)
C WD9P|Castlevania - The Adventure ReBirth (Europe) (WiiWare)
C WCVE|Cave Story (World) (WiiWare)
C WKTP|Contra ReBirth (World) (WiiWare)
W WMJP|Dive - The Medes Islands Secret (Europe) (WiiWare)
S WEQP|Equilibrio (Europe) (WiiWare)
W W9IE|Evasive Space (World) (WiiWare)
S WWRP|Excitebike - World Challenge (Europe) (WiiWare)
W WFYP|Family Games - Pen & Paper Edition (Europe) (WiiWare)
C WRLP|FAST - Racing League (Europe) (WiiWare)
S WCIP|Final Fantasy - Crystal Defender R1 (Europe) (WiiWare)
S WC2P|Final Fantasy - Crystal Defender R2 (Europe) (WiiWare)
C WF2P|Final Fantasy Crystal Chronicles - My Life as a Darklord (Europe) (WiiWare)
C WFCP|Final Fantasy Crystal Chronicles - My Life as a King (Europe) (WiiWare)
C WF4P|Final Fantasy IV - The After Years (Europe) (WiiWare)
N WVSP|Gods vs. Humans (Europe) (WiiWare)
C WGDP|Gradius ReBirth (Europe) (v257) (WiiWare)
C WGYE|Gyrostarr (USA to Europe) (WiiWare)
W WLGE|HB Arcade Cards (World) (WiiWare)
N WHFP|Heavy Fire - Special Operations (Europe) (WiiWare)
N WHWP|HoopWorld (Europe) (WiiWare)
S WFLP|Hydroventure (Europe) (WiiWare)
C WLMP|La-Mulana (Europe) (WiiWare)
S WLZP|Lilt Line (Europe) (WiiWare)
N WLTE|LIT (World) (WiiWare)
N WLWP|LostWinds (Europe) (WiiWare)
N WLOP|LostWinds Winter of the Melodias (World) (WiiWare)
C WRXP|Mega Man 10 (Europe) (WiiWare)
C WR9P|Mega Man 9 (Europe) (WiiWare)
W WM4P|Mix Superstar (Europe) (WiiWare)
S WAJP|MotoHeroz (Europe) (WiiWare)
W W2OP|My Aquarium 2 (Europe) (WiiWare)
N WBME|My Pokemon Ranch (World) (WiiWare)
W WP7P|My Starry Night (Europe) (WiiWare)
N WICP|NyxQuest - Kindred Spirits (Europe) (WiiWare)
C WP3P|Pearl Harbor - Episode 1 - Red Sun Rising (Europe) (WiiWare)
C WPAJ|Pokemon Fushigi no Dungeon - Ikuzo! Arashi no Boukendan (Japan) (WiiWare)
C WPHJ|Pokemon Fushigi no Dungeon - Mezase! Hikari no Boukendan (Japan) (WiiWare)
C WPFJ|Pokemon Fushigi no Dungeon - Susume! Honou no Boukendan (Japan) (WiiWare)
C WPSP|Pokemon Rumble (Europe) (WiiWare)
N WR2P|Rabbids Lab (World) (WiiWare)
C WR5P|Retro City Rampage (Europe) (WiiWare)
N WZIP|Rubik's Puzzle Galaxy - RUSH (Europe) (WiiWare)
S WSNE|Sonic The Hedgehog 4 Episode I (Europe) (WiiWare)
W WSWP|Swords & Soldiers (Europe) (WiiWare)
N WILP|Tales of Monkey Island - Chapter 1 - Launch of the Screaming Narwhal (Europe) (WiiWare)
N WISP|Tales of Monkey Island - Chapter 2 - The Siege of Spinner Cay (World) (WiiWare)
N WIEP|Tales of Monkey Island - Chapter 3 - Lair of the Leviathan (World) (WiiWare)
N WIYP|Tales of Monkey Island - Chapter 4 - The Trial and Execution of Guybrush Threepwood (World) (WiiWare)
N WIRP|Tales of Monkey Island - Chapter 5 - Rise of the Pirate God (Europe) (WiiWare)
C W3KP|ThruSpace - High Velocity 3D Puzzle (Europe) (WiiWare)
N WA7P|Toribash - Violence Perfected (Europe) (WiiWare)
W WA4P|WarioWare D.I.Y. Showcase (Europe) (WiiWare)
W WGOE|World of Goo (World) (WiiWare)
N WZPP|Zombie Panic in Wonderland (Europe) (WiiWare)